NO ./Sprites/north.xpm
SO ./Sprites/south.xpm
WE ./Sprites/west.xpm
EA ./Sprites/east.xpm

F 255,100,255
C 255,100,0



    111111
    1000001
    1000001
    1000001
    10N0001
   1000001
    1111111

