NO ./Sprites/north.xpm
SO ./Sprites/south.xpm
WE ./Sprites/west.xpm
EA ./Sprites/east.xpm

F 220,100,0
C 225,30,0

11111111111111111111111111
1000000000000000000001
1000000000N0000000000111111
100000000000000000001
1000111111111111110001
10001            10001
11111            11111
